5
5
1
XXXXX
Xk  X
XH  X
XI  X
XXXXX
