12
12
1
XIIIIIIIIIIX
XI        XX
X         XX
X         XX
X         XX
X         XX
X         XX
XH    kXXXXX
X     XXXXXX
XXXXXXXXXXXX
XXXXXXXXXXXX
XXXXXXXXXXXX
