5
5
2
XXIIX
XHk X
X   X
X   X
XXXXX
