5
5
1
XIIIX
X  kX
X   X
X H X
XIIIX
