11
11
1
XIIIIXXXXXX
I     XX  X
I    XXI  X
I    X XX X
I   X XXX X
I XXXXXXX X
II  XXXXX X
XIIXXXXX  X
X XXXXX   X
XH      kXX
XXXXXXXXXXX
